Anomoly
weekend effect : 주말효과, 종가와 다음날 시가를 계산해서 수익률 분석, 코스피 지수가 가장 낮은거
코스피 지수, 대용치(ETF : 거래소에서 매매되는 펀드)
물가안정과 경제성장 트레이트오프 관계
한국은행 설립목적 : 물가안정 => 물가안정을 잡기위한 수단 : 금리(물가안정, 환율)
Fed : 연방 준비 제도 -> 금리 (물가안정, 고용)
환율 올라감 => 물가상승
alternative investment (대체 투자) ex) 부동산, 실물
주식 채권 비율 6:4(경기 좋을때) or 4:6(경기가 안좋을때)
금리 올라감 => 채권가격하락
https://github.com/freejyb
외한시장 == 한시
wag the dog = 파생상품 시장이 주식시장을 움직인다

1. 금융 트렌드 변화 & Digital Banking

금융 : 자금 조달, 운용 - 예금, 채권발행(누구나 가능), 대출, 주식발행(주식회사만 가능) 
디지털 뱅킹 : 비즈니스 모델이 디지털로 변환된 것
DX : 디지털 트랜스포메이션
72법칙 = 72 / 복리
금리 = 경제성장률 + 물가
리밸런싱 : 원래 전략한것을 환원시키는 것
리스크 프리미엄 : 5-6%
무위험 수익률 : 3%
매출액 - 원금(거래처) - 인건비(근로자) - 이자(채권) - 세금(국가) - 이익(주주)
ROE > 8-10% 넘어야 이득
포용금융
디지털 송장 금융(digital invoice financing)
슈퍼앱 : 결제 및 금융 거래 처리를 포함한 여러 서비스를 합친 어플
IPO : 신규 상장
임베디드 금융 : 금융회사가 아닌데 금융을 판매하는 것, 금융이 탑재된 것
BNPL (Buy Now Pay  Later) : 후불결제
빅블러 시대 : 산업 간 경계가 모호화되는 현상
지배구조 : 경영자, 채권자, 주주
투자 대상 선정기준 : 기대수익, 위험 (둘은 trade off 관계)
Var : 분산 VaR : 위험관리를 위해 사용되는 개념 VAR : 변인오토인코더
기대수익(평균) 위험(Var)

2. 금융 / 재무 입문

T : 만기   t : 현재 시점 T - t : 잔존기간
Rt : 시계열  Rit : 패널데이터
주식투자에서 얻는 수익 : 매매차익, 배당
D(배당금) / P(투자시점 주당가격) = d(배당수익률) 
배당성향 : 배당 / 순이익         미국 : 45%          한국 : 25%
유보율( 1 - 배당성향 )
로그변환 사용하는 피쳐 : 매출액, 총자산
E(Ri) : i종목 기대 수익률
PER(기대, 신뢰반영) = P(주가) / EPS(주당순이익)
1 / PER :기대 수익률
금리가 낮은 나라는 PER가 높다 / 금리가 높은 나라는 PER가 낮다
민감도(베타) : 시장이 변할때 개별 종목이 변하는 평균적 민감도
민감도 > 1 => 공격적 		민감도 < 1 => 방어적
PBR = P(주가) / BPS(장부상가치)
PBR < 1 => 저평가된 기업, 0.1처럼 너무 낮은경우 부실기업
Zero Growth Model => 어떤 기업이 매년 D(배당) 지원		이 기업의 가치(P) = D / r		성장률 기업(P) = D / r-g
fair game : 투자금액과 기대금액이 같은 게임
시장이 효율적이면 베타는 1로 수렴 => 조정베타 사용해서 1에 가깝게 만듬
SMB : 소기업 수익률과 대기업의 수익률 차이		HML : 성장하는 기업의 수익률과 가치있는 기업의 수익률 차이

유가증권시장 == 코스피시장 : 주식뿐만 아니라 채권도 거래되는 시장 (메인은 주식)
OTC market : 장외시장
자금조달 : 여유자금(유보자금), 부채(은행 대출, 채권 발행), 주식발행(유상증자 => 나쁜소식)
주식수 증가 <-> 주식수 감소 => 배당이익 => 자사주 매입(좋은 소식)


채권시장 이해

공사에서 발행한 채권들을 나라에서 인증을 해준다
채권은 이표채는 6개월마다 보통 지급
투자적격등급(AAA, AA, A, BBB) 		투기등급(그 이하)
Parity = 주가 / 전환가격 
전환사채와 신주인수권부사채의 차이는 전환사채는 주식으로 전환하면 사채권을 잃고 신주인수권부사채는 그렇지 않음
BIS(국제 결제 은행) 비율 = 자기자본 / 위험자산(대출, 채권) >= 8 %
보완자본 : 채권이긴 하지만 자본으로 인정해주는 거
Mezzanine Fund : 전환사채, 신주인수권부사채 같은 곳에 투자하는 펀드
Conventional : 채권 입찰에서 낙찰금액 범위에서 응찰자가 제시한 수익률로 채권을 발행하는 것 (여러 조건)
Dutch : 채권 입잘에서 단일금리결정방식을 의미 (한 조건)
총액인수 : 인수기관이 제3자에게 매도할 목적으로 공모주식 전액을 매입하는 방식
채권 듀레이션 : 투자자가 투자한 원금을 회수하는 데 드는 평균적인 기간
복리채, 할인채의 Duration = 잔존만기
이표채의 Duration < 잔존만기
YTM : 현재의 채권 가격과 채권을 보유했을 때 미래 현금흐름의 현재가치와 일치시켜주는 수익률
경기가 안좋을때 : 국공채매입 => 유동성 업 => 금리 다운
경기가 좋을때 : 국공채매각 => 유동성 다운 => 금리 업
실질GDP의 변화율 : (금년GDP - 전년GDP) / 전년 실질 GDP


거시경제 메카니즘 이해

GDP = 소비(C) + 투자지출(I) + 소비지출(G) + 순수출(수출 - 수입)
경상 : 경제 상황에서 일상적으로 일어나는 일
무역 / GDP > 100% => 무역 비중이 높은 나라
CPI : 소비자가 구입하는 상품이나 서비스의 가격변동을 나타내는 지수 (한국에서 사용하는 물가지수)
PCE : 개인소비지출 물가지수 (미국에서 사용하는 물가지수)
Inflation의 원인 : 수요견인인플레이션 vs 비용인상인플레이션
D의 공포 : Deflation이 바닥으로 가는 것
RP거래(환매조건부매매) : 일정 기간 이후 정해진 가격으로 되사는(되파는) 것을 조건으로 증권을 파는(사는) 것을 의미
공개시장조작 : 한국과 미국에서 물가안정을 위해 하는 통화조절정책
부동자금 : 부포처럼 명확한 투자처를 찾지 못한 상태에서 떠돌아다니는 자금
부동자금 = M1 + MMF, CMA(M2의 일부분)
CLI : 경기선행지수
CDS : 대출이나 채권 투자에서 손실을 다른 투자자가 대신 포상해주는 파생상품
MSCI 지수 : 모건 스탠리 캐피탈 인터내셔널에서만든 주가 지수

물가는 환율의 장기적인 요인
금리는 환율의 단기적인 요인
USD/KRW => 앞에 오는 화폐가 단위 ex) 1달러당 1250원
교차환율 : 외한 시세에서 어느 한 나라의 통화와 제3국 통화 사이의 환율
재정환율 : 기준 환율과 크로스레이트에 의하여 간접적으로 산정된 한 나라 화폐의 각국 화폐에 대한 환율
SDR(특별인출권) : 국제통화기금 가맹국이 국제 수지 악화 때 담보 없이 필요한 만큼의 외화를 인출할 수 있는 권리
통화스왑 : 서로 다른 통화를 약정된 환율에 따라 일정한 시점에서 상호 교환하는 거래
CRS금리 : 통화스왑 시장에서 달러를 주고 원화로 교환하는데 원화를 받을 때 적용되는 금리


금융상품 비교 분석

상업은행 : 간접금융을 주로 하는 은행 (자금중개)

투자은행 : 직접금융을 주로 하는 은행 

ELD(주가 연계예금) : 은행에서 판매하는 상품으로 원금이 보장되며 시중금리 이상의 수익률을 추구하는 상품

국민연금과 신연금저축 비교
- 국민연금은 물가상승률을 고려
- 국민연금은 인풋과 아웃풋이 다르다 (소득 재분배)
 
Factor : 어떠한 특성을 보이는 집단 (소형주 + 변동성)

후순위 채권 : 은행 등의 회사가 파산 등으로 법정관리에 들어가거나 청산 절차를 밟을 경우 다른 부채를 모두 갚고 난 다음에 돈을 받을 수 있는 권리를 가진 채권

ROE = 순이익 / ((전기자본 + 단기자본) / 2) * 100%

IFRS : 국제회계기준

소형주 효과 : 소기업 주식에 투자하면 위험은 크지만 정상 수익보다 큰 수익을 얻는 현상

초과 수익 : 무위험 수익률을 초과하는 수익

WACC (가중평균자본비용)		Kd < WACC < Ke
D / (D + E) * Kd(1 - t) + E / (D + E) * Kd		(D : 부채, E : 자기자본, Kd = 이자 / 평균 부채비용, Ke : 요구수익률)

샤프지수 = 초과수익률 / 위험 : 금융에서 투자성과를 평가함에 있어 해당 투자의 위험을 조정해 반영하는 방식

이자율 평가 이론 : 위험과 만기는 같으나 표시 통화만 다른 두 금융 상품이 있을 때 이 가운데 한 금융 상품에 투자한 수익률과 다른 금융 상품에 투자하여 선물환으로 헤지를 하는 경우의 수익률이 같아야 한다는 이론

NDF : 선물환거래의 일종으로 만기일에 당초 약정환율과 만기일의 현물환율간의 차액을 특정통화로 결제하는 거래






